
|---|---|---|
| ? | X | ? |
|---|---|---|
| X | 0 | X |
|---|---|---|
| X | 0 | X |
|---|---|---|
| ? | 0 | ? |
|---|---|---|
| ? | ? | ? |
|---|---|---|

NUMBER OF MOVEMENTS: 1
