**********
..........
*..\....\*
*/.\...\\*
*........*
*....\.\.*
*\\......*
*....\.\.*
*\\....\.*
**********

**********
*/........
*../....\*
*\./...//*
*........*
*...././.*
*/\......*
*....\.\.*
./\..../.*
**********

*.************************************************
*...../.........................................\*
*\....//......................................../*
*/...../.........................................*
*\................................\..............*
*.................................\............\.*
*.../........................................../.*
*...\...................\........................*
*......../............../........................*
*../...../.......................................*
*................................................*
*..\....................................\........*
*................................................*
*......../........\....../............../........*
*.................\....../.......................*
*................................................*
*........\...........................\...........*
*................................................*
*................................................*
*................................................*
*............./....................../...........*
*................................................*
*................................................*
*................................................*
*.............\............................\.....*
*................................................*
*................................................*
*................................................*
*................................................*
*................................................*
*.............../........................../.....*
*................................................*
*................................................*
*................................................*
*................................................*
*................................................*
*................................................*
*................................................*
*................................................*
*................................................*
*................................................*
*................................................*
*................................................*
*...............\.....................\..........*
*..................../................/..........*
*....................\...........\...............*
*......./......................../...............*
*.......\.......................................\*
*................................................*
************************************************.*
