**********
*/........
*../....\*
*\./...//*
*........*
*...././.*
*/\......*
*....\.\.*
./\..../.*
**********

